{
  "maps": [
    {
      "id": 1,
      "layout": [
        "____________________________",
        "____________________________",
        "______||||||||||||||||______",
        "______|iovbnivbnivbon|______",
        "______|n||v||||||v||i|______",
        "______|b||b||||||b||v|______",
        "______|v||niv||vin||b|______",
        "______|i||||b||b||||n|______",
        "|||||||n||||n||n||||i|||||||",
        "vbnivbni||vbnivbni||vbnivbvb",
        "|||v||||||b||||||v||||||n|||",
        "|||b||||||n||||||b||||||i|||",
        "|inbvinb||ivb||vin||nbvinbv|",
        "|v|||||v||||n||b||||i|||||b|",
        "|b|||||i||||i||n||||v|||||n|",
        "|nivb||nbvinbvinbvinb||vbni|",
        "||||n||||v|||==|||v||||b||||",
        "||||i||||b|______|b||||n||||",
        "vb||bnivbn|______|nvbnvi||vb",
        "|n||v||||i|______|i||||v||i|",
        "|ibni||||v||||||||v||||bvbn|",
        "|v||v||inbnivbnivbniv||n||i|",
        "|b||b||v||||||||||||b||i||v|",
        "|n||n||b||||||||||||n||v||b|",
        "vi||i||nivbni||vinbvi||b||ni",
        "||||v|||||||v||b|||||||n||||",
        "||||b|||||||b||n|||||||i||||",
        "|bvinbvinbvin  ivbnivbnivbn|",
        "|n||v||||||||||||||||||v||n|",
        "|i||i|________________|b||b|",
        "|o||n|________________|n||o|",
        "|v||b|________________|i||v|",
        "|bniv|________________|vbni|",
        "||||||________________||||||",
        "____________________________",
        "____________________________"
      ]
    },
    {
      "id": 2,
      "layout": [
        "____________________________",
        "____________________________",
        "____________________________",
        "||||||||||||||||||||||||||||",
        "|vbnivbnivbni||vbnivbnivbni|",
        "|b||||b|||||v||v|||||v||||v|",
        "|o|__|v|___|b||b|___|i|__|o|",
        "|n||||i|||||n||n|||||n||||b|",
        "|ibnivnivbnivbnivbnivbbivbn|",
        "|v||||b||v||||||||v||v||||i|",
        "|b||||v||b||||||||n||i||||v|",
        "|nivbni||nvvv||nnii||nbvinb|",
        "||||||n|||||n||b|||||i||||||",
        "_____|n|||||n||i|||||n|_____",
        "_____|i||nniivviibi||v|_____",
        "_____|k||i|||==|||n||i|_____",
        "||||||n||n|______|b||b||||||",
        "nbbvvniniv|______|bbibnibvvv",
        "||||||n||n|______|n||n||||||",
        "_____|i||i||||||||i||i|_____",
        "_____|v||vivbnivbnv||v|_____",
        "_____|b||b||||||||b||b|_____",
        "||||||n||n||||||||n||n||||||",
        "|nivbnivbnivb||nbvinvinivbn|",
        "|i||||v|||||n||i|||||v||||i|",
        "|v||||b|||||i||v|||||b||||v|",
        "|obn||nbvinbv  bnivbnn||ino|",
        "|||i||i||n||||||||i||i||v|||",
        "|||v||v||i||||||||v||v||b|||",
        "|vbnivb||nivb||nivb||bnivbn|",
        "|i||||||||||n||i||||||||||i|",
        "|n||||||||||i||v||||||||||b|",
        "|inbvinbvinbvinbvinbvinbvin|",
        "||||||||||||||||||||||||||||",
        "____________________________",
        "____________________________"
      ]
    },
    {
      "id": 3,
      "layout": [
        "____________________________",
        "____________________________",
        "____________________________",
        "||||||||||||||||||||||||||||",
        "|nvbini||ibbbvvviib||abvbii|",
        "|o||||b||i||||||||b||b||||o|",
        "|o||||n||n||||||||b||n||||o|",
        "|bbbnbvnbivbvnvnbivbvnvbnbv|",
        "|||n||v|||||b||i|||||n||i|||",
        "__|i||n|___|v||v|___|i||i|__",
        "|||n||v|||||n|||||||v||nb|||",
        "nvbi||bbinvvn||nnvviib||bovv",
        "|||n|||||n||||||||v|||||n|||",
        "__|i|||||i||||||||b|||||v|__",
        "__|iivnivvvvvnnnbvinivnvu|__",
        "__|n|||||i|||==|||i|||||i|__",
        "__|i|||||n|______|n|||||i|__",
        "__|i||nvbi|______|nvbi||n|__",
        "__|b||i||i|______|v||n||b|__",
        "|||b||n||i||||||||n||b||n|||",
        "nivbbbb||niiinniibn||nbvbini",
        "|||n||||||||i||n||||||||i|||",
        "__|i||||||||v||i||||||||n|__",
        "__|vninnivvvi||nvnnibinin|__",
        "__|v|||||v||||||||i|||||n|__",
        "|||n|||||n||||||||n|||||i|||",
        "|ninivbbbvvni  bnininbninnv|",
        "|n||||n|||||v||v|||||b||||v|",
        "|i|__|i|||||v||n|||||b|__|i|",
        "|i|__|n||vvnn||iibb||b|__|i|",
        "|o|__|v||n||||||||b||b|__|o|",
        "|n||||n||i||||||||i||v||||n|",
        "|nibinibnivvvvvnninbnvbninv|",
        "||||||||||||||||||||||||||||",
        "____________________________",
        "____________________________"
      ]
    },
    {
      "id": 4,
      "layout": [
        "____________________________",
        "____________________________",
        "____________________________",
        "||||||||||||||||||||||||||||",
        "|vvvvvnnin||vvbb||vvvvvnnin|",
        "|o|||||||n||i||n||n|||||||o|",
        "|n|||||||i||b||v||i|||||||n|",
        "|v||vvvvvnnin||vvvvvnnin||v|",
        "|b||n||||||n||n||||i||ni||n|",
        "|biib||i||||v||n||||b||biib|",
        "||||b||i||||i||i||||n||b||||",
        "||||v||ninivvininninb||n||||",
        " nvbi||||v||||||||b||||vvnn ",
        "|n||i||||i||||||||v||||b||n|",
        "|b||vvvivnninbvbinvnninb||v|",
        "|v||||n||n|||==|||n||n||||b|",
        "|i||||i||b|______|v||i||||i|",
        "|vvvvvn||i|______|b||vvvvvn|",
        "|n||i||||i|______|i||||b||n|",
        "|v||b||||n||||||||n||||v||b|",
        "|b||vvvvvnninbbnbnvninin||n|",
        "|i||||i|||||n||v|||||v||||i|",
        "|n||||b|||||n||n|||||n||||n|",
        "|biinin||vbii||bii||biibniv|",
        "|||n||i||n||||||||n||b||b|||",
        "|||n||b||b||||||||i||i||n|||",
        "|o||bnvnvin  vvvvvnn||iio|",
        "|v||||n|||||b||n|||||n||||v|",
        "|n||||v|||||v||i|||||v||||n|",
        "|bniinb||bnin||bnin||bninin|",
        "|i||||i||v||||||||b||b||||n|",
        "|v||||v||n||||||||n||n||||b|",
        "|bninin||nibinibniv||bninin|",
        "||||||||||||||||||||||||||||",
        "____________________________",
        "____________________________"
      ]
    },
    {
      "id": 5,
      "layout": [
        "____________________________",
        "____________________________",
        "____________________________",
        "||||||||||||||||||||||||||||",
        "|nvbinvbivnvbivvnvbinvbinvb|",
        "|v||b|________________|i||v|",
        "|o||i||||n||||||||v||||v||o|",
        "|n||b||||i||nvbi||b||||n||i|",
        "|v||nvbiin||i||n||nvbini||v|",
        "|b||||v||v||v||n||b||v||||b|",
        "|i||||i||b||n||v||i||b||||n|",
        "|nvbinv||nvbi||nvbi||nvbiin|",
        "|||v||||||||v||i||||||||n|||",
        "__|i||||||||n||v||||||||i|__",
        "__|nvbi||nvbinvbinv||nvbi|__",
        "||| ||v||i|||==|||i||n|| |||",
        "    ||b||n|______|v||v||    ",
        "||||||ivbi|______|nvbi||||||",
        "||||||n||i|______|v||n||||||",
        "nvbi||v||b||||||||i||b||vbin",
        "|||n||b||binvbinvvv||i||i|||",
        "__|vivb|||||n||i|||||vbin|__",
        "__|b||v|||||v||v|||||i||v|__",
        "__|n||inbinvb||binvbin||b|__",
        "__|i|||||v||n||v||n|||||i|__",
        "|||n|||||b||i||i||b|||||v|||",
        "|nibinvini||v  i||bnbinvbin|",
        "|b||||b||i||||||||n||i||||v|",
        "|v||||n||v||||||||n||n||||b|",
        "|i||inb||binvbinvbi||vbi||n|",
        "|o||n|||||||b||i|||||||v||o|",
        "|n||i|||||||i||n|||||||i||i|",
        "|inbinvbinbin||binvbinvbinv|",
        "||||||||||||||||||||||||||||",
        "____________________________",
        "____________________________"
      ]
    }
  ]
}